###############
#S#   #       #
# # # # ##### #
#   #       # #
# # # ####### #
# # # #       #
# # ### ##### #
# #     # #   #
# ####### # ###
#         #   #
# ##### ### # #
#   #   #   # #
### # ### ### #
#   #        D#
###############
