bfs found a path of length: 48
###############
#S#.#.....#...#
#x#.#.#.###.#.#
#x#...#.....#.#
#x###########.#
#xxxxx#xxxxx#.#
#####x#x###x#.#
#   #xxx#.#xxx#
# #######.###x#
#   #xxxxx#xxx#
### #x###x#x###
#..,#x#.#xxx# #
#.###x#.##### #
#....xxxxxxxxD#
###############

