#######
#S  # #
### # #
# # # #
# #####
#    D#
#######
