###############
#S# #     #   #
# # # # ### # #
# #   #     # #
# ########### #
#     #     # #
##### # ### # #
#   #   # #   #
# ####### ### #
#   #     #   #
### # ### # ###
#   # # #   # #
# ### # ##### #
#            D#
###############
