#######
#S    #
#     #
#     #
#  D  #
#     #
#######
