#######
#S    #
### # #
#   # #
# ### #
#    D#
#######
