#######
#S#   #
# ### #
# #   #
# # # #
#   #D#
#######
