bfs found a path of length: 28
###############
#S#...#.......#
#x#.#.#.#####.#
#x..#.......#.#
#x#.#.#######.#
#x#.#.#.......#
#x#.###.#####.#
#x#.....#.#...#
#x#######.#.###
#xxxxxxx..#...#
#.#####x###.#,#
#...#xxx#...# #
###.#x###.### #
#...#xxxxxxxxD#
###############

